00000000000000000000000000000000000000000000000000000000000000000000000000000000000000000000000000000000000000000000000000000000
00000000000000000000000000000000000000000000000000000000000000000000000000000000000000000000000000000000000000000000000000000000
00000000000000000000000000000000000000000000000000000000000000000000000000000000000000000000000000000000000000000000000000000000
00000000000000000000000000000001111111110111111111111111111000000000000000000000000000000000000000000000000000000000000000000000
00000000000000000000000000110010111110101100000000000000100000000001111000000000000000000000000000011000000000000000000000000000
00000000000000000000011111010011000000010011000000000000100000000000000000000000000001100000000000100100000000001100000000000000
00000000000000000000111001001110111110000000100000000000100000000000000000000000010000000000001111000011111110000000000000000000
00000011111100000000001110110110100111100000100000001111000000000000000111100000000000011111110000000000000001111111111111000000
10000100000011111111110000001001001001011000100001110000000000000000011100011111111111100000000000000000000000000000000000111111
01001000000000000000000000000001111101110000010010000001111000000001101010000000000000000000000000000000000000000000000000000010
00001100011111000000000000000010000111000000001100000000000000000110010100000000000000000000000000000000000000000000001100111100
00000011100000110000000000000100000100101000000000000000000000000101010010000000000000000000000000000000000000000111110011000000
00000010000000001000000000000011100010010100000000000000000001100010100100000000000000000000000000000000000000001000000111000000
00000000000000000100000000000000010100000011000000000000000010110011011000000000000000000000000000000000000000000100000100000000
00000000000000000010000000000000101000001101000000000000000000101100000000000000000000000000000000000000000000000110000000000000
00000000000000000001000000000001010000010011100000000000000000110000000000110000110000000000000000000000000000001000000000000000
00000000000000000001000000000000100000111100000000000000000000010111010001001101001000000000000000000000000000110000000000000000
00000000000000000001000000000000000001000000000000000000000011101000101010000010101000000000000000000000000101000110000000000000
00000000000000000000100000000000000010000000000000000000000010110000010111111100100100000000000000000000001010000100000000000000
00000000000000000000100000000000000010000000000000000000000001001110000001110000011000000000000000000000010011001100000000000000
00000000000000000000010000000000000100000000000000000000000010110001000000001000000000000000000000000000001000010000000000000000
00000000000000000000001100000111111000000000000000000000000010000000111111110000010000000000000000000000001000000000000000000000
00000000000000000000000010001000001000000000000000000000000100000000000000001000101010000000000000000000010000000000000000000000
00000000000000000000000001001000000000000000000000000000001000000000000000010100010101110000000000000000010000000000000000000000
00000000000000000000000000101000001100000000000000000000001000000000000000010100001100001000001110000101100000000000000000000000
00000000000000000000000000111001000000000000000000000000001000000000000000001010001100000100010001001010000000000000000000000000
00000000000000000000000000001111000000000000000000000000010000000000000000000101110000000100100001000100001000000000000000000000
00000000000000000000000000000001110000000000000000000000010000000000000000000101000000000011000000110010001000000000000000000000
00000000000000000000000000000000010001111000000000000000001000000000000000000010110000000011000000101100000100000000000000000000
00000000000000000000000000000000001010000110000000000000000100001000000000000001100000000001100000100000000100000000000000000000
00000000000000000000000000000000000010000001100000000000000011110110000000000000100000000000000000010000100000000000000000000000
00000000000000000000000000000000000010000000010000000000000000000001000000010001000000000000000000110001100000000000000000000000
00000000000000000000000000000000000100000000010000000000000000000001000000101010000000000000000000010010100000000000000000000000
00000000000000000000000000000000001000000000001111000000000000000001000000010100000000000000000000011001101000011100000000000000
00000000000000000000000000000000000100000000000000100000000000000000100000000100000000000000000000000100000000001010000000000000
00000000000000000000000000000000000100000000000000100000000000000000100000000100000000000000000000000000000000000110000000000000
00000000000000000000000000000000000010000000000000100000000000000000100000000100000000000000000000000000000000000000000000000000
00000000000000000000000000000000000010000000000001000000000000000000100000000100100000000000000000000000000010110010000000000000
00000000000000000000000000000000000001000000000001000000000000000000100000001001100000000000000000000000000101001011000000000000
00000000000000000000000000000000000000100000000010000000000000000000100000010001100000000000000000000000001000000101000000000000
00000000000000000000000000000000000000100000000110000000000000000000100000010001100000000000000000000000110000000000100000000000
00000000000000000000000000000000000000100000001000000000000000000000010000010000000000000000000000000000100000000000010000000000
00000000000000000000000000000000000000100000010000000000000000000000010000100000000000000000000000000000100000000000010000000000
00000000000000000000000000000000000000100000010000000000000000000000001001000000000000000000000000000000100111100000010000000000
00000000000000000000000000000000000000100000100000000000000000000000001110000000000000000000000000000000111000011000100000000000
00000000000000000000000000000000000001000011000000000000000000000000000000000000000000000000000000000000000000000111100000000100
00000000000000000000000000000000000001000100000000000000000000000000000000000000000000000000000000000000000000000000000000000110
00000000000000000000000000000000000001001000000000000000000000000000000000000000000000000000000000000000000000000001000000001000
00000000000000000000000000000000000001010000000000000000000000000000000000000000000000000000000000000000000000000000000000010000
00000000000000000000000000000000000001010000000000000000000000000000000000000000000000000000000000000000000000000000000000000000
00000000000000000000000000000000000001100000000000000000000000000000000000000000000000000000000000000000000000000000000000000000
00000000000000000000000000000000000000100000000000000000000000000000000000000000000000000000000000000000000000000000000000000000
00000000000000000000000000000000000000000000000000000000000000000000000000000000000000000000000000000000000000000000000000000000
00000000000000000000000000000000000000000000000000000000000000000000000000000000000000000000000000000000000000000000000000000000
00000000000000000000000000000000000000000000000000000000000000000000000000000000000000000000000000000000000000000000000000000000
00000000000000000000000000000000000000000010000000000000000000000000000000000000000000000000000000000000000000000000000000000000
00000000000000000000000000000000000000001100000000000000000000000000000000000000011110000000111111111111111111111110000000000000
00000000000000000000000000000000000001110100000000000000000000111111111111111111100001111111000000000000000000000001111100000000
00000000000000000000000000011111111110000100000000000000011111000000000000000000000000000000000000000000000000000000000010000000
11111111111111111111111111100000000000000010000000000011100000000000000000000000000000000000000000000000000000000000000001111111
00000000000000000000000000000000000000000001111111111100000000000000000000000000000000000000000000000000000000000000000000000000
00000000000000000000000000000000000000000000000000000000000000000000000000000000000000000000000000000000000000000000000000000000
00000000000000000000000000000000000000000000000000000000000000000000000000000000000000000000000000000000000000000000000000000000
00000000000000000000000000000000000000000000000000000000000000000000000000000000000000000000000000000000000000000000000000000000
00000000000000000000000000000000000000000000000000000000000000000000000000000000000000000000000000000000000000000000000000000000
