                                                                                                                                
                                                                                                                                
                                                                                                                                
                               🞄🞄🞄🞄🞄🞄🞄🞄🞄 🞄🞄🞄🞄🞄🞄🞄🞄🞄🞄🞄🞄🞄🞄🞄🞄🞄🞄                                                                     
                          🞄🞄  🞄▓🞄🞄🞄🞄🞄 🞄▓🞄🞄▓▓▓▓▓▓▓▓▓▓▓▓▓▓🞄          🞄🞄🞄🞄                            🞄🞄                           
                     🞄🞄🞄🞄🞄 🞄  🞄🞄       🞄  🞄🞄▓▓▓▓▓▓▓▓▓▓▓▓🞄                            🞄🞄           🞄▓▓🞄          🞄🞄              
                    🞄🞄🞄  🞄  🞄🞄🞄 🞄🞄🞄🞄🞄       🞄▓▓▓▓▓▓▓▓▓▓▓🞄                        🞄            🞄🞄🞄🞄▓▓▓▓🞄🞄🞄🞄🞄🞄🞄                   
      🞄🞄🞄🞄🞄🞄          🞄🞄🞄▓🞄🞄 🞄🞄 🞄▓▓▓▓🞄🞄     🞄▓▓▓▓▓▓▓🞄🞄🞄🞄               🞄🞄🞄🞄            🞄🞄🞄🞄🞄🞄🞄▓▓▓▓▓▓▓▓▓▓▓▓▓▓▓🞄🞄🞄🞄🞄🞄🞄🞄🞄🞄🞄🞄🞄      
🞄    🞄▓▓▓▓▓▓🞄🞄🞄🞄🞄🞄🞄🞄🞄🞄▓▓▓▓▓▓🞄▓▓🞄▓▓🞄  🞄▓🞄🞄   🞄▓▓▓▓🞄🞄🞄                 🞄🞄🞄🞄🞄🞄🞄🞄🞄🞄🞄🞄🞄🞄🞄🞄🞄🞄▓▓▓▓▓▓▓▓▓▓▓▓▓▓▓▓▓▓▓▓▓▓▓▓▓▓▓▓▓▓▓▓▓▓▓🞄🞄🞄🞄🞄🞄
 🞄  🞄▓▓▓▓▓▓▓▓▓▓▓▓▓▓▓▓▓▓▓▓▓▓▓▓▓▓🞄🞄🞄🞄🞄 🞄🞄🞄     🞄▓▓🞄      🞄🞄🞄🞄        🞄▓▓🞄 🞄▓▓▓▓▓▓▓▓▓▓▓▓▓▓▓▓▓▓▓▓▓▓▓▓▓▓▓▓▓▓▓▓▓▓▓▓▓▓▓▓▓▓▓▓▓▓▓▓▓▓▓▓▓🞄 
    🞄🞄▓▓▓🞄🞄🞄🞄🞄▓▓▓▓▓▓▓▓▓▓▓▓▓▓▓▓🞄    🞄🞄🞄        🞄🞄                 🞄🞄▓▓🞄 🞄▓▓▓▓▓▓▓▓▓▓▓▓▓▓▓▓▓▓▓▓▓▓▓▓▓▓▓▓▓▓▓▓▓▓▓▓▓▓▓▓▓▓▓▓▓▓🞄🞄▓▓🞄🞄🞄🞄  
      🞄🞄🞄     🞄🞄▓▓▓▓▓▓▓▓▓▓▓▓▓🞄     🞄▓▓🞄 🞄                        🞄▓🞄▓🞄  🞄▓▓▓▓▓▓▓▓▓▓▓▓▓▓▓▓▓▓▓▓▓▓▓▓▓▓▓▓▓▓▓▓▓▓▓▓▓▓▓▓🞄🞄🞄🞄🞄  🞄🞄      
      🞄         🞄▓▓▓▓▓▓▓▓▓▓▓▓▓🞄🞄🞄   🞄▓▓🞄▓🞄                   🞄🞄   🞄 🞄  🞄▓▓▓▓▓▓▓▓▓▓▓▓▓▓▓▓▓▓▓▓▓▓▓▓▓▓▓▓▓▓▓▓▓▓▓▓▓▓▓▓🞄      🞄🞄🞄      
                 🞄▓▓▓▓▓▓▓▓▓▓▓▓▓▓▓🞄 🞄▓▓▓▓▓▓🞄🞄                🞄 🞄🞄  🞄🞄▓🞄🞄▓▓▓▓▓▓▓▓▓▓▓▓▓▓▓▓▓▓▓▓▓▓▓▓▓▓▓▓▓▓▓▓▓▓▓▓▓▓▓▓▓▓🞄     🞄        
                  🞄▓▓▓▓▓▓▓▓▓▓▓▓▓🞄▓🞄▓▓▓▓▓🞄🞄▓🞄                  🞄 🞄🞄▓▓▓▓▓▓▓▓▓▓▓▓▓▓▓▓▓▓▓▓▓▓▓▓▓▓▓▓▓▓▓▓▓▓▓▓▓▓▓▓▓▓▓▓▓▓▓🞄🞄             
                   🞄▓▓▓▓▓▓▓▓▓▓▓🞄 🞄▓▓▓▓▓🞄  🞄🞄🞄                 🞄🞄▓▓▓▓▓▓▓▓▓▓🞄🞄▓▓▓▓🞄🞄▓▓▓▓▓▓▓▓▓▓▓▓▓▓▓▓▓▓▓▓▓▓▓▓▓▓▓▓▓▓🞄               
                   🞄▓▓▓▓▓▓▓▓▓▓▓▓🞄▓▓▓▓▓🞄🞄🞄🞄                     🞄▓🞄🞄🞄▓🞄▓▓▓🞄  🞄🞄▓🞄  🞄▓▓▓▓▓▓▓▓▓▓▓▓▓▓▓▓▓▓▓▓▓▓▓▓▓▓▓🞄🞄                
                   🞄▓▓▓▓▓▓▓▓▓▓▓▓▓▓▓▓▓🞄                      🞄🞄🞄▓🞄   🞄 🞄▓🞄     🞄▓🞄 🞄▓▓▓▓▓▓▓▓▓▓▓▓▓▓▓▓▓▓▓▓▓▓▓▓🞄▓🞄   🞄🞄             
                    🞄▓▓▓▓▓▓▓▓▓▓▓▓▓▓▓🞄                       🞄▓🞄🞄     🞄 🞄▓🞄🞄🞄🞄🞄▓▓🞄  🞄▓▓▓▓▓▓▓▓▓▓▓▓▓▓▓▓▓▓▓▓▓▓🞄 🞄    🞄              
                    🞄▓▓▓▓▓▓▓▓▓▓▓▓▓▓▓🞄                        🞄  🞄🞄🞄      🞄🞄🞄▓▓▓▓▓🞄🞄▓▓▓▓▓▓▓▓▓▓▓▓▓▓▓▓▓▓▓▓▓▓🞄  🞄🞄  🞄🞄              
                     🞄▓▓▓▓▓▓▓▓▓▓▓▓▓🞄                        🞄▓🞄🞄▓▓▓🞄        🞄▓▓▓▓▓▓▓▓▓▓▓▓▓▓▓▓▓▓▓▓▓▓▓▓▓▓▓▓▓🞄    🞄                
                      🞄🞄▓▓▓▓▓🞄🞄🞄🞄🞄🞄                         🞄▓▓▓▓▓▓▓🞄🞄🞄🞄🞄🞄🞄🞄▓▓▓▓▓🞄▓▓▓▓▓▓▓▓▓▓▓▓▓▓▓▓▓▓▓▓▓▓▓▓🞄                     
                        🞄▓▓▓🞄     🞄                        🞄▓▓▓▓▓▓▓▓▓▓▓▓▓▓▓▓🞄▓▓▓🞄 🞄▓🞄▓▓▓▓▓▓▓▓▓▓▓▓▓▓▓▓▓▓▓▓🞄                      
                         🞄▓▓🞄                             🞄▓▓▓▓▓▓▓▓▓▓▓▓▓▓▓▓🞄 🞄▓▓▓🞄 🞄 🞄🞄🞄▓▓▓▓▓▓▓▓▓▓▓▓▓▓▓▓▓🞄                      
                          🞄▓🞄     🞄🞄                      🞄▓▓▓▓▓▓▓▓▓▓▓▓▓▓▓▓🞄 🞄▓▓▓▓▓🞄    🞄▓▓▓▓▓🞄🞄🞄▓▓▓▓🞄▓🞄🞄                       
                          🞄🞄🞄  🞄                          🞄▓▓▓▓▓▓▓▓▓▓▓▓▓▓▓▓▓🞄 🞄▓▓▓🞄🞄     🞄▓▓▓🞄   🞄▓▓🞄 🞄                         
                            🞄🞄🞄🞄                         🞄▓▓▓▓▓▓▓▓▓▓▓▓▓▓▓▓▓▓▓🞄 🞄🞄🞄       🞄▓▓🞄    🞄▓▓▓🞄    🞄                     
                               🞄🞄🞄                       🞄▓▓▓▓▓▓▓▓▓▓▓▓▓▓▓▓▓▓▓🞄 🞄          🞄🞄      🞄🞄▓▓🞄   🞄                     
                                 🞄   🞄🞄🞄🞄                 🞄▓▓▓▓▓▓▓▓▓▓▓▓▓▓▓▓▓▓▓🞄 🞄🞄        🞄🞄      🞄 🞄🞄     🞄                    
                                  🞄 🞄▓▓▓▓▓🞄                🞄▓▓▓▓🞄▓▓▓▓▓▓▓▓▓▓▓▓▓▓🞄🞄          🞄🞄     🞄        🞄                    
                                    🞄▓▓▓▓▓▓🞄🞄               🞄🞄🞄🞄 🞄▓▓▓▓▓▓▓▓▓▓▓▓▓▓🞄                  🞄    🞄                       
                                    🞄▓▓▓▓▓▓▓▓🞄                     🞄▓▓▓▓▓▓▓🞄▓▓▓🞄                  🞄🞄   🞄🞄                       
                                   🞄▓▓▓▓▓▓▓▓▓🞄                     🞄▓▓▓▓▓▓🞄 🞄▓🞄                    🞄  🞄▓🞄                       
                                  🞄▓▓▓▓▓▓▓▓▓▓▓🞄🞄🞄🞄                 🞄▓▓▓▓▓▓▓🞄▓🞄                     🞄🞄  🞄🞄 🞄    🞄🞄🞄              
                                   🞄▓▓▓▓▓▓▓▓▓▓▓▓▓▓🞄                 🞄▓▓▓▓▓▓▓▓🞄                       🞄          🞄▓🞄             
                                   🞄▓▓▓▓▓▓▓▓▓▓▓▓▓▓🞄                 🞄▓▓▓▓▓▓▓▓🞄                                   🞄🞄             
                                    🞄▓▓▓▓▓▓▓▓▓▓▓▓▓🞄                 🞄▓▓▓▓▓▓▓▓🞄                                                  
                                    🞄▓▓▓▓▓▓▓▓▓▓▓▓🞄                  🞄▓▓▓▓▓▓▓▓🞄  🞄                           🞄 🞄🞄  🞄             
                                     🞄▓▓▓▓▓▓▓▓▓▓▓🞄                  🞄▓▓▓▓▓▓▓🞄  🞄🞄                          🞄▓▓▓▓🞄 🞄🞄            
                                      🞄▓▓▓▓▓▓▓▓▓🞄                   🞄▓▓▓▓▓▓🞄   🞄🞄                         🞄▓▓▓▓▓▓🞄▓🞄            
                                      🞄▓▓▓▓▓▓▓▓🞄🞄                   🞄▓▓▓▓▓▓🞄   🞄🞄                       🞄▓▓▓▓▓▓▓▓▓▓▓🞄           
                                      🞄▓▓▓▓▓▓▓🞄                      🞄▓▓▓▓▓🞄                            🞄▓▓▓▓▓▓▓▓▓▓▓▓🞄          
                                      🞄▓▓▓▓▓▓🞄                       🞄▓▓▓▓🞄                             🞄▓▓▓▓▓▓▓▓▓▓▓▓🞄          
                                      🞄▓▓▓▓▓▓🞄                        🞄▓▓🞄                              🞄▓▓🞄🞄🞄🞄▓▓▓▓▓▓🞄          
                                      🞄▓▓▓▓▓🞄                         🞄🞄🞄                               🞄🞄🞄    🞄▓▓▓▓🞄           
                                     🞄▓▓▓▓🞄🞄                                                                     🞄🞄🞄🞄        🞄  
                                     🞄▓▓▓🞄                                                                                   🞄🞄 
                                     🞄▓▓🞄                                                                          🞄        🞄   
                                     🞄▓🞄                                                                                   🞄    
                                     🞄▓🞄                                                                                        
                                     🞄🞄                                                                                         
                                      🞄                                                                                         
                                                                                                                                
                                                                                                                                
