                                                                                                                                
                                                                                                                                
                                                                                                                                
                               🞄🞄🞄🞄🞄🞄🞄🞄🞄 🞄🞄🞄🞄🞄🞄🞄🞄🞄🞄🞄🞄🞄🞄🞄🞄🞄🞄                                                                     
                          🞄🞄  🞄 🞄🞄🞄🞄🞄 🞄 🞄🞄              🞄          🞄🞄🞄🞄                            🞄🞄                           
                     🞄🞄🞄🞄🞄 🞄  🞄🞄       🞄  🞄🞄            🞄                            🞄🞄           🞄  🞄          🞄🞄              
                    🞄🞄🞄  🞄  🞄🞄🞄 🞄🞄🞄🞄🞄       🞄           🞄                        🞄            🞄🞄🞄🞄    🞄🞄🞄🞄🞄🞄🞄                   
      🞄🞄🞄🞄🞄🞄          🞄🞄🞄 🞄🞄 🞄🞄 🞄    🞄🞄     🞄       🞄🞄🞄🞄               🞄🞄🞄🞄            🞄🞄🞄🞄🞄🞄🞄               🞄🞄🞄🞄🞄🞄🞄🞄🞄🞄🞄🞄🞄      
🞄    🞄      🞄🞄🞄🞄🞄🞄🞄🞄🞄🞄      🞄  🞄  🞄  🞄 🞄🞄   🞄    🞄🞄🞄                 🞄🞄🞄🞄🞄🞄🞄🞄🞄🞄🞄🞄🞄🞄🞄🞄🞄🞄                                   🞄🞄🞄🞄🞄🞄
 🞄  🞄                          🞄🞄🞄🞄🞄 🞄🞄🞄     🞄  🞄      🞄🞄🞄🞄        🞄  🞄 🞄                                                     🞄 
    🞄🞄   🞄🞄🞄🞄🞄                🞄    🞄🞄🞄        🞄🞄                 🞄🞄  🞄 🞄                                              🞄🞄  🞄🞄🞄🞄  
      🞄🞄🞄     🞄🞄             🞄     🞄  🞄 🞄                        🞄 🞄 🞄  🞄                                        🞄🞄🞄🞄🞄  🞄🞄      
      🞄         🞄             🞄🞄🞄   🞄  🞄 🞄                   🞄🞄   🞄 🞄  🞄                                        🞄      🞄🞄🞄      
                 🞄               🞄 🞄      🞄🞄                🞄 🞄🞄  🞄🞄 🞄🞄                                          🞄     🞄        
                  🞄             🞄 🞄     🞄🞄 🞄                  🞄 🞄🞄                                               🞄🞄             
                   🞄           🞄 🞄     🞄  🞄🞄🞄                 🞄🞄          🞄🞄    🞄🞄                              🞄               
                   🞄            🞄     🞄🞄🞄🞄                     🞄 🞄🞄🞄 🞄   🞄  🞄🞄 🞄  🞄                           🞄🞄                
                   🞄                 🞄                      🞄🞄🞄 🞄   🞄 🞄 🞄     🞄 🞄 🞄                        🞄 🞄   🞄🞄             
                    🞄               🞄                       🞄 🞄🞄     🞄 🞄 🞄🞄🞄🞄🞄  🞄  🞄                      🞄 🞄    🞄              
                    🞄               🞄                        🞄  🞄🞄🞄      🞄🞄🞄     🞄🞄                      🞄  🞄🞄  🞄🞄              
                     🞄             🞄                        🞄 🞄🞄   🞄        🞄                             🞄    🞄                
                      🞄🞄     🞄🞄🞄🞄🞄🞄                         🞄       🞄🞄🞄🞄🞄🞄🞄🞄     🞄                        🞄                     
                        🞄   🞄     🞄                        🞄                🞄   🞄 🞄 🞄                    🞄                      
                         🞄  🞄                             🞄                🞄 🞄   🞄 🞄 🞄🞄🞄                 🞄                      
                          🞄 🞄     🞄🞄                      🞄                🞄 🞄     🞄    🞄     🞄🞄🞄    🞄 🞄🞄                       
                          🞄🞄🞄  🞄                          🞄                 🞄 🞄   🞄🞄     🞄   🞄   🞄  🞄 🞄                         
                            🞄🞄🞄🞄                         🞄                   🞄 🞄🞄🞄       🞄  🞄    🞄   🞄    🞄                     
                               🞄🞄🞄                       🞄                   🞄 🞄          🞄🞄      🞄🞄  🞄   🞄                     
                                 🞄   🞄🞄🞄🞄                 🞄                   🞄 🞄🞄        🞄🞄      🞄 🞄🞄     🞄                    
                                  🞄 🞄     🞄                🞄    🞄              🞄🞄          🞄🞄     🞄        🞄                    
                                    🞄      🞄🞄               🞄🞄🞄🞄 🞄              🞄                  🞄    🞄                       
                                    🞄        🞄                     🞄       🞄   🞄                  🞄🞄   🞄🞄                       
                                   🞄         🞄                     🞄      🞄 🞄 🞄                    🞄  🞄 🞄                       
                                  🞄           🞄🞄🞄🞄                 🞄       🞄 🞄                     🞄🞄  🞄🞄 🞄    🞄🞄🞄              
                                   🞄              🞄                 🞄        🞄                       🞄          🞄 🞄             
                                   🞄              🞄                 🞄        🞄                                   🞄🞄             
                                    🞄             🞄                 🞄        🞄                                                  
                                    🞄            🞄                  🞄        🞄  🞄                           🞄 🞄🞄  🞄             
                                     🞄           🞄                  🞄       🞄  🞄🞄                          🞄    🞄 🞄🞄            
                                      🞄         🞄                   🞄      🞄   🞄🞄                         🞄      🞄 🞄            
                                      🞄        🞄🞄                   🞄      🞄   🞄🞄                       🞄           🞄           
                                      🞄       🞄                      🞄     🞄                            🞄            🞄          
                                      🞄      🞄                       🞄    🞄                             🞄            🞄          
                                      🞄      🞄                        🞄  🞄                              🞄  🞄🞄🞄🞄      🞄          
                                      🞄     🞄                         🞄🞄🞄                               🞄🞄🞄    🞄    🞄           
                                     🞄    🞄🞄                                                                     🞄🞄🞄🞄        🞄  
                                     🞄   🞄                                                                                   🞄🞄 
                                     🞄  🞄                                                                          🞄        🞄   
                                     🞄 🞄                                                                                   🞄    
                                     🞄 🞄                                                                                        
                                     🞄🞄                                                                                         
                                      🞄                                                                                         
                                                                                                                                
                                                                                                                                
