00000000000000000000000000000000000000000000000000000000000000000000000000000000000000000000000000000000000000000000000000000000
00000000000000000000000000000000000000000000000000000000000000000000000000000000000000000000000000000000000000000000000000000000
00000000000000000000000000000000000000000000000000000000000000000000000000000000000000000000000000000000000000000000000000000000
00000000000000000000000000000001111111110111111111111111111000000000000000000000000000000000000000000000000000000000000000000000
00000000000000000000000000110011111110111111111111111111100000000001111000000000000000000000000000011000000000000000000000000000
00000000000000000000011111010011000000010011111111111111100000000000000000000000000001100000000000111100000000001100000000000000
00000000000000000000111001001110111110000000111111111111100000000000000000000000010000000000001111111111111110000000000000000000
00000011111100000000001111110110111111100000111111111111000000000000000111100000000000011111111111111111111111111111111111000000
10000111111111111111111111111111111001111000111111110000000000000000011111111111111111111111111111111111111111111111111111111111
01001111111111111111111111111111111101110000011110000001111000000001111011111111111111111111111111111111111111111111111111111110
00001111111111111111111111111110000111000000001100000000000000000111110111111111111111111111111111111111111111111111111111111100
00000011100000111111111111111100000111101000000000000000000000000111110011111111111111111111111111111111111111111111110011000000
00000010000000001111111111111111100011111100000000000000000001100010100111111111111111111111111111111111111111111000000111000000
00000000000000000111111111111111110111111111000000000000000010110011111111111111111111111111111111111111111111111100000100000000
00000000000000000011111111111111111111111111000000000000000000101111111111111111111111111111111111111111111111111110000000000000
00000000000000000001111111111111011111110011100000000000000000111111111111111111111111111111111111111111111111111000000000000000
00000000000000000001111111111111111111111100000000000000000000011111111111001111001111111111111111111111111111110000000000000000
00000000000000000001111111111111111111000000000000000000000011111000101110000011101111111111111111111111111111000110000000000000
00000000000000000000111111111111111110000000000000000000000011110000010111111111100111111111111111111111111010000100000000000000
00000000000000000000111111111111111110000000000000000000000001001110000001111111111111111111111111111111110011001100000000000000
00000000000000000000011111111111111100000000000000000000000011111111000000001111111111111111111111111111111000010000000000000000
00000000000000000000001111111111111000000000000000000000000011111111111111111111111111111111111111111111111000000000000000000000
00000000000000000000000011111000001000000000000000000000000111111111111111111111101111111111111111111111110000000000000000000000
00000000000000000000000001111000000000000000000000000000001111111111111111110111110101111111111111111111110000000000000000000000
00000000000000000000000000111000001100000000000000000000001111111111111111110111111100001111111111111111100000000000000000000000
00000000000000000000000000111001000000000000000000000000001111111111111111111011111100000111110001111010000000000000000000000000
00000000000000000000000000001111000000000000000000000000011111111111111111111101110000000111100001111100001000000000000000000000
00000000000000000000000000000001110000000000000000000000011111111111111111111101000000000011000000111110001000000000000000000000
00000000000000000000000000000000010001111000000000000000001111111111111111111110110000000011000000101100000100000000000000000000
00000000000000000000000000000000001011111110000000000000000111111111111111111111100000000001100000100000000100000000000000000000
00000000000000000000000000000000000011111111100000000000000011110111111111111111100000000000000000010000100000000000000000000000
00000000000000000000000000000000000011111111110000000000000000000001111111111111000000000000000000110001100000000000000000000000
00000000000000000000000000000000000111111111110000000000000000000001111111101110000000000000000000010011100000000000000000000000
00000000000000000000000000000000001111111111111111000000000000000001111111111100000000000000000000011001101000011100000000000000
00000000000000000000000000000000000111111111111111100000000000000000111111111100000000000000000000000100000000001110000000000000
00000000000000000000000000000000000111111111111111100000000000000000111111111100000000000000000000000000000000000110000000000000
00000000000000000000000000000000000011111111111111100000000000000000111111111100000000000000000000000000000000000000000000000000
00000000000000000000000000000000000011111111111111000000000000000000111111111100100000000000000000000000000010110010000000000000
00000000000000000000000000000000000001111111111111000000000000000000111111111001100000000000000000000000000111111011000000000000
00000000000000000000000000000000000000111111111110000000000000000000111111110001100000000000000000000000001111111111000000000000
00000000000000000000000000000000000000111111111110000000000000000000111111110001100000000000000000000000111111111111100000000000
00000000000000000000000000000000000000111111111000000000000000000000011111110000000000000000000000000000111111111111110000000000
00000000000000000000000000000000000000111111110000000000000000000000011111100000000000000000000000000000111111111111110000000000
00000000000000000000000000000000000000111111110000000000000000000000001111000000000000000000000000000000111111111111110000000000
00000000000000000000000000000000000000111111100000000000000000000000001110000000000000000000000000000000111000011111100000000000
00000000000000000000000000000000000001111111000000000000000000000000000000000000000000000000000000000000000000000111100000000100
00000000000000000000000000000000000001111100000000000000000000000000000000000000000000000000000000000000000000000000000000000110
00000000000000000000000000000000000001111000000000000000000000000000000000000000000000000000000000000000000000000001000000001000
00000000000000000000000000000000000001110000000000000000000000000000000000000000000000000000000000000000000000000000000000010000
00000000000000000000000000000000000001110000000000000000000000000000000000000000000000000000000000000000000000000000000000000000
00000000000000000000000000000000000001100000000000000000000000000000000000000000000000000000000000000000000000000000000000000000
00000000000000000000000000000000000000100000000000000000000000000000000000000000000000000000000000000000000000000000000000000000
00000000000000000000000000000000000000000000000000000000000000000000000000000000000000000000000000000000000000000000000000000000
00000000000000000000000000000000000000000000000000000000000000000000000000000000000000000000000000000000000000000000000000000000
00000000000000000000000000000000000000000000000000000000000000000000000000000000000000000000000000000000000000000000000000000000
00000000000000000000000000000000000000000010000000000000000000000000000000000000000000000000000000000000000000000000000000000000
00000000000000000000000000000000000000001100000000000000000000000000000000000000011110000000111111111111111111111110000000000000
00000000000000000000000000000000000001111100000000000000000000111111111111111111111111111111111111111111111111111111111100000000
00000000000000000000000000011111111111111100000000000000011111111111111111111111111111111111111111111111111111111111111110000000
11111111111111111111111111111111111111111110000000000011111111111111111111111111111111111111111111111111111111111111111111111111
11111111111111111111111111111111111111111111111111111111111111111111111111111111111111111111111111111111111111111111111111111111
11111111111111111111111111111111111111111111111111111111111111111111111111111111111111111111111111111111111111111111111111111111
11111111111111111111111111111111111111111111111111111111111111111111111111111111111111111111111111111111111111111111111111111111
11111111111111111111111111111111111111111111111111111111111111111111111111111111111111111111111111111111111111111111111111111111
11111111111111111111111111111111111111111111111111111111111111111111111111111111111111111111111111111111111111111111111111111111
