000000000000000000000000000000000000000000000000000000000000000000000000000000000000000000000000000000000000000000000000000000000000000000000000000000
000000000000000000000000000000000000000000000000000000000000000000000000000000000000000000000000000000000000000000000000000000000000000000000000000000
000000000000000000000000000000000000000000000000000000000000000000000000000000000000000000000000000000000000000000000000000000000000000000000000000000
000000000000000000000000000000000000111111111110111111111111111111111000000000000000000000000000000000000000000000000000000000000000000000000000000000
000000000000000000000000000000000000100000010010100000000000000000011000000000000000000000000000000000000000000000000000000000000000000000000000000000
000000000000000000000000000000111001011111101101100000000000000000100000000000011110000000000000000000000000000000001100000000000000000000000000000000
000000000000000000000000011111001001100000000010011100000000000000100000000000000000000000000000000011000000000000010011000000000001110000000000000000
000000000000000000000001111001000111011111100000000010000000000000100000000000000000000000000001000000000000001111100000111111110000000000000000000000
000000011111110000000000001110111011010001111100000010000000011111000000000000000001111100000000000000111111110000000000000000001111111111111110000000
100000100000001111111111110000000100100010010011000010000111100000000000000000000111000011111111111111000000000000000000000000000000000000000001111111
010001000000000000000000000000000000000001010010000001001000000011111000000000011010100000000000000000000000000000000000000000000000000000000000000010
010001000000000000000000000000000000111111011110000001001000000011111000000000010010100000000000000000000000000000000000000000000000000000000000000010
000001100011111100000000000000000001000001110000000000110000000000000000000011100101000000000000000000000000000000000000000000000000000000111001111100
000000011100000011100000000000000010000001001101000000000000000000000000000010010100100000000000000000000000000000000000000000000000111111000110000000
000000010000000000010000000000000001111000100010100000000000000000000001110001101001000000000000000000000000000000000000000000000001000000001110000000
000000000000000000001000000000000000000101000000011100000000000000000010011001010110000000000000000000000000000000000000000000000000110000001000000000
000000000000000000000100000000000000011010000001100100000000000000000000010110000000000000000000000000000000000000000000000000000000111000000000000000
000000000000000000000010000000000000100100000010010010000000000000000000011000000000000000000000000000000000000000000000000000000001000000000000000000
000000000000000000000010000000000000100100000010011110000000000000000000010000000000000110000011000000000000000000000000000000000001000000000000000000
000000000000000000000010000000000000011000001111100000000000000000000000001011110100001001100100100000000000000000000000000000000110000000000000000000
000000000000000000000010000000000000000000010000000000000000000000000011110100001010010000010010100000000000000000000000000001101000111000000000000000
000000000000000000000001000000000000000000100000000000000000000000000010011000000101111111100010010000000000000000000000000010010000110000000000000000
000000000000000000000001100000000000000000100000000000000000000000000001100111100000001110000001100000000000000000000000000100011001110000000000000000
000000000000000000000000010000000000000001000000000000000000000000000010011000010000000001000000000000000000000000000000000010000010000000000000000000
000000000000000000000000010000000000000001000000000000000000000000000010000000010000000001000000000000000000000000000000000010000010000000000000000000
000000000000000000000000001100000011111110000000000000000000000000000010000000001111111110000001000000000000000000000000000010000000000000000000000000
000000000000000000000000000010000100000010000000000000000000000000000100000000000000000001000010101100000000000000000000000100000000000000000000000000
000000000000000000000000000001000100000000000000000000000000000000001000000000000000000010100001010011100000000000000000000100000000000000000000000000
000000000000000000000000000000100100000011000000000000000000000000001000000000000000000010100000110000010000001111000011011000000000000000000000000000
000000000000000000000000000000111100100000000000000000000000000000001000000000000000000001011000110000001000010000100100100000000000000000000000000000
000000000000000000000000000000000111100000000000000000000000000000010000000000000000000000100101000000001000100000100011000010000000000000000000000000
000000000000000000000000000000000111100000000000000000000000000000010000000000000000000000100111000000001100100000100001000010000000000000000000000000
000000000000000000000000000000000000111100000000000000000000000000010000000000000000000000100100000000000011000000011000100010000000000000000000000000
000000000000000000000000000000000000000100011111000000000000000000001000000000000000000000011011000000000011000000010111000001100000000000000000000000
000000000000000000000000000000000000000010100000110000000000000000000100000100000000000000000110000000000001100000010000000001100000000000000000000000
000000000000000000000000000000000000000000100000001110000000000000000011111011100000000000000010000000000000000000001000001000000000000000000000000000
000000000000000000000000000000000000000000100000000001000000000000000000000000010000000010000100000000000000000000011000011000000000000000000000000000
000000000000000000000000000000000000000001000000000001000000000000000000000000010000000101001000000000000000000000001000101000000000000000000000000000
000000000000000000000000000000000000000001000000000001000000000000000000000000010000000101011000000000000000000000001000101000000000000000000000000000
000000000000000000000000000000000000000010000000000000111110000000000000000000010000000010100000000000000000000000001100011010000011110000000000000000
000000000000000000000000000000000000000001000000000000000001000000000000000000001000000000100000000000000000000000000011000000000001001000000000000000
000000000000000000000000000000000000000001000000000000000001000000000000000000001000000000100000000000000000000000000000000000000000111000000000000000
000000000000000000000000000000000000000000100000000000000001000000000000000000001000000000100000000000000000000000000000000000000000000000000000000000
000000000000000000000000000000000000000000100000000000000010000000000000000000001000000000100010000000000000000000000000000000010110001000000000000000
000000000000000000000000000000000000000000010000000000000010000000000000000000001000000001000110000000000000000000000000000001101001001100000000000000
000000000000000000000000000000000000000000010000000000000110000000000000000000001000000001000110000000000000000000000000000001000001001100000000000000
000000000000000000000000000000000000000000001000000000001000000000000000000000001000000010000110000000000000000000000000000010000000110100000000000000
000000000000000000000000000000000000000000001000000000011000000000000000000000001000000010000110000000000000000000000000001100000000000010000000000000
000000000000000000000000000000000000000000001000000000100000000000000000000000000100000010000000000000000000000000000000001000000000000001000000000000
000000000000000000000000000000000000000000001000000001000000000000000000000000000100000100000000000000000000000000000000001000000000000001000000000000
000000000000000000000000000000000000000000001000000001000000000000000000000000000010001000000000000000000000000000000000001001111100000001000000000000
000000000000000000000000000000000000000000001000000010000000000000000000000000000010010000000000000000000000000000000000001010000010000010000000000000
000000000000000000000000000000000000000000001000000010000000000000000000000000000011110000000000000000000000000000000000001110000011000010000000000000
000000000000000000000000000000000000000000010000011100000000000000000000000000000000000000000000000000000000000000000000000000000000111110000000000100
000000000000000000000000000000000000000000010000100000000000000000000000000000000000000000000000000000000000000000000000000000000000000000000000000110
000000000000000000000000000000000000000000010001000000000000000000000000000000000000000000000000000000000000000000000000000000000000000100000000011000
000000000000000000000000000000000000000000010010000000000000000000000000000000000000000000000000000000000000000000000000000000000000000000000000100000
000000000000000000000000000000000000000000010010000000000000000000000000000000000000000000000000000000000000000000000000000000000000000000000000000000
000000000000000000000000000000000000000000010010000000000000000000000000000000000000000000000000000000000000000000000000000000000000000000000000000000
000000000000000000000000000000000000000000010100000000000000000000000000000000000000000000000000000000000000000000000000000000000000000000000000000000
000000000000000000000000000000000000000000001100000000000000000000000000000000000000000000000000000000000000000000000000000000000000000000000000000000
000000000000000000000000000000000000000000000000000000000000000000000000000000000000000000000000000000000000000000000000000000000000000000000000000000
000000000000000000000000000000000000000000000000000000000000000000000000000000000000000000000000000000000000000000000000000000000000000000000000000000
000000000000000000000000000000000000000000000000000000000000000000000000000000000000000000000000000000000000000000000000000000000000000000000000000000
000000000000000000000000000000000000000000000000010000000000000000000000000000000000000000000000000000000000000000000000000000000000000000000000000000
000000000000000000000000000000000000000000000000010000000000000000000000000000000000000000000000000000000000000000000000000000000000000000000000000000
000000000000000000000000000000000000000000000001100000000000000000000000000000000000000000000001111100000000111111111111111111111111111000000000000000
000000000000000000000000000000000000000000011110100000000000000000000000011111111111111111111110000011111111000000000000000000000000000111111000000000
000000000000000000000000000000001111111111100000100000000000000000011111100000000000000000000000000000000000000000000000000000000000000000000100000000
111111111111111111111111111111110000000000000000010000000000000111100000000000000000000000000000000000000000000000000000000000000000000000000011111111
000000000000000000000000000000000000000000000000001111111111111000000000000000000000000000000000000000000000000000000000000000000000000000000000000000
000000000000000000000000000000000000000000000000000000000000000000000000000000000000000000000000000000000000000000000000000000000000000000000000000000
000000000000000000000000000000000000000000000000000000000000000000000000000000000000000000000000000000000000000000000000000000000000000000000000000000
000000000000000000000000000000000000000000000000000000000000000000000000000000000000000000000000000000000000000000000000000000000000000000000000000000
000000000000000000000000000000000000000000000000000000000000000000000000000000000000000000000000000000000000000000000000000000000000000000000000000000
000000000000000000000000000000000000000000000000000000000000000000000000000000000000000000000000000000000000000000000000000000000000000000000000000000
