222222222222222222222222222222222222222222222222222222222222222222222222222222222222222222222222222222222222222222222222222222222222222222222222222222
222222222222222222222222222222222222222222222222222222222222222222222222222222222222222222222222222222222222222222222222222222222222222222222222222222
222222222222222222222222222222222222222222222222222222222222222222222222222222222222222222222222222222222222222222222222222222222222222222222222222222
222222222222222222222222222222222222111111111112333333333333333333333222222222222222222222222222222222222222222222222222222222222222222222222222222222
222222222222222222222222222222222222111111111112333333333333333333333222222222222222222222222222222222222222222222222222222222222222222222222222222222
222222222222222222222222222222111221111111121113333333333333333333322222222222233332222222222222222222222222222222221122222222222222222222222222222222
222222222222222222222222211111221221122222222212233333333333333333322555555555555555555555555555555533222222222222211111222222222221112222222222222222
222222222222222222222221111221222111211111122222222233333333333333355555555555555555555555555551555522222222221111111111111111112222222222222222222222
555555511111112222222222221111111211211111111122222233333333333333555555555555555551111155555555555522111111111111111111111111111111111111111112222225
155555111111111111111111111111111111111112211111222233333333355555555555555555555111111111111111111111111111111111111111111111111111111111111111111111
515551111111111111111111111111111111111111211112222223333555555511111555555555511115111111111111111111111111111111111111111111111111111111111111111115
515551111111111111111111111111111111111111211112222223333555555511111555555555511115111111111111111111111111111111111111111111111111111111111111111115
555551111111111111111111111111111111555551115555555555115555555555555555555511111151111111111111111111111111111111111111111111111111111111111111111155
555555511155555511111111111111111115555551111151555555555555555555555555555511111155111111111111111111111111111111111111111111111111111111555115555555
555555515555555555511111111111111111111555111111155555555555555555555551115551151551111111111111111111111111111111111111111111111111555555551115555555
555555555555555555551111111111111111111151111111111155555555555555555515511551111111111111111111111111111111111111111111111111111111115555551555555555
555555555555555555555111111111111111111111111111111155555555555555555555515111111111111111111111111111111111111111111111111111111111111555555555555555
555555555555555555555511111111111111155111111115511115555555555555555555511111111111111111111111111111111111111111111111111111111111555555555555555555
555555555555555555555511111111111111155111111115511115555555555555555555511111111111111111111111111111111111111111111111111111111111555555555555555555
555555555555555555555511111111111111111111111111155555555555555555555555551111111111111551111155111111111111111111111111111111111115555555555555555555
555555555555555555555511111111111111111111115555555555555555555555555511111155551511115555511115111111111111111111111111111111111555111555555555555555
555555555555555555555551111111111111111111155555555555555555555555555511111555555151111111111115511111111111111111111111111115515555115555555555555555
555555555555555555555551111111111111111111155555555555555555555555555551155111155555551111111111111111111111111111111111111155511551115555555555555555
555555555555555555555555511111111111111111555555555555555555555555555511111111115555555551111111111111111111111111111111111115555515555555555555555555
555555555555555555555555511111111111111111555555555555555555555555555511111111115555555551111111111111111111111111111111111115555515555555555555555555
555555555555555555555555551111111111111115555555555555555555555555555511111111111111111111111111111111111111111111111111111115555555555555555555555555
555555555555555555555555555511111155555515555555555555555555555555555111111111111111111111111115111111111111111111111111111155555555555555555555555555
555555555555555555555555555551111155555555555555555555555555555555551111111111111111111115111111515511111111111111111111111155555555555555555555555555
555555555555555555555555555555111155555511555555555555555555555555551111111111111111111115111111115555511111111111111111111555555555555555555555555555
555555555555555555555555555555111155155555555555555555555555555555551111111111111111111111511111115555551111115555111155155555555555555555555555555555
555555555555555555555555555555555111155555555555555555555555555555511111111111111111111111155111555555551111155555111111555515555555555555555555555555
555555555555555555555555555555555111155555555555555555555555555555511111111111111111111111155111555555551111155555111111555515555555555555555555555555
555555555555555555555555555555555555111155555555555555555555555555511111111111111111111111155155555555555511555555511111155515555555555555555555555555
555555555555555555555555555555555555555155511111555555555555555555551111111111111111111111111511555555555511555555515111555551155555555555555555555555
555555555555555555555555555555555555555515111111115555555555555555555111111111111111111111111115555555555551155555515555555551155555555555555555555555
555555555555555555555555555555555555555555111111111115555555555555555511111511111111111111111115555555555555555555551555551555555555555555555555555555
555555555555555555555555555555555555555555111111111111555555555555555555555555511111111111111155555555555555555555511555511555555555555555555555555555
555555555555555555555555555555555555555551111111111111555555555555555555555555511111111151111555555555555555555555551555111555555555555555555555555555
555555555555555555555555555555555555555551111111111111555555555555555555555555511111111151111555555555555555555555551555111555555555555555555555555555
555555555555555555555555555555555555555511111111111111111115555555555555555555511111111111155555555555555555555555551155511515555511115555555555555555
555555555555555555555555555555555555555551111111111111111111555555555555555555551111111111155555555555555555555555555511555555555551111555555555555555
555555555555555555555555555555555555555551111111111111111111555555555555555555551111111111155555555555555555555555555555555555555555111555555555555555
555555555555555555555555555555555555555555111111111111111111555555555555555555551111111111155555555555555555555555555555555555555555555555555555555555
555555555555555555555555555555555555555555111111111111111115555555555555555555551111111111155515555555555555555555555555555555515115551555555555555555
555555555555555555555555555555555555555555511111111111111115555555555555555555551111111111555115555555555555555555555555555551111111551155555555555555
555555555555555555555555555555555555555555511111111111111115555555555555555555551111111111555115555555555555555555555555555551111111551155555555555555
555555555555555555555555555555555555555555551111111111111555555555555555555555551111111115555115555555555555555555555555555511111111111155555555555555
555555555555555555555555555555555555555555551111111111111555555555555555555555551111111115555115555555555555555555555555551111111111111115555555555555
555555555555555555555555555555555555555555551111111111155555555555555555555555555111111115555555555555555555555555555555551111111111111111555555555555
555555555555555555555555555555555555555555551111111111555555555555555555555555555111111155555555555555555555555555555555551111111111111111555555555555
555555555555555555555555555555555555555555551111111111555555555555555555555555555511111555555555555555555555555555555555551111111111111111555555555555
555555555555555555555555555555555555555555551111111115555555555555555555555555555511115555555555555555555555555555555555551115555511111115555555555555
555555555555555555555555555555555555555555551111111115555555555555555555555555555511115555555555555555555555555555555555551115555511111115555555555555
555555555555555555555555555555555555555555511111111155555555555555555555555555555555555555555555555555555555555555555555555555555555111115555555555155
555555555555555555555555555555555555555555511111155555555555555555555555555555555555555555555555555555555555555555555555555555555555555555555555555115
555555555555555555555555555555555555555555511111555555555555555555555555555555555555555555555555555555555555555555555555555555555555555155555555511555
555555555555555555555555555555555555555555511115555555555555555555555555555555555555555555555555555555555555555555555555555555555555555555555555155555
555555555555555555555555555555555555555555511115555555555555555555555555555555555555555555555555555555555555555555555555555555555555555555555555555555
555555555555555555555555555555555555555555511115555555555555555555555555555555555555555555555555555555555555555555555555555555555555555555555555555555
555555555555555555555555555555555555555555511155555555555555555555555555555555555555555555555555555555555555555555555555555555555555555555555555555555
555555555555555555555555555555555555555555551155555555555555555555555555555555555555555555555555555555555555555555555555555555555555555555555555555555
555555555555555555555555555555555555555555555555555555555555555555555555555555555555555555555555555555555555555555555555555555555555555555555555555555
555555555555555555555555555555555555555555555555555555555555555555555555555555555555555555555555555555555555555555555555555555555555555555555555555555
555555555555555555555555555555555555555555555555555555555555555555555555555555555555555555555555555555555555555555555555555555555555555555555555555555
222222222222222222222222222222222222222222222222232222222222222222222222222222222222222222222222222222222222222222222222222222222222222222222222222222
222222222222222222222222222222222222222222222222232222222222222222222222222222222222222222222222222222222222222222222222222222222222222222222222222222
222222222222222222222222222222222222222222222223322222222222222222222222222222222222222222222223333322222222333333333333333333333333333222222222222222
222222222222222222222222222222222222222222233333322222222222222222222222233333333333333333333333333333333333333333333333333333333333333333333222222222
222222222222222222222222222222223333333333333333322222222222222222233333333333333333333333333333333333333333333333333333333333333333333333333322222222
333333333333333333333333333333333333333333333333332222222222222333333333333333333333333333333333333333333333333333333333333333333333333333333333333333
333333333333333333333333333333333333333333333333333333333333333333333333333333333333333333333333333333333333333333333333333333333333333333333333333333
333333333333333333333333333333333333333333333333333333333333333333333333333333333333333333333333333333333333333333333333333333333333333333333333333333
333333333333333333333333333333333333333333333333333333333333333333333333333333333333333333333333333333333333333333333333333333333333333333333333333333
333333333333333333333333333333333333333333333333333333333333333333333333333333333333333333333333333333333333333333333333333333333333333333333333333333
333333333333333333333333333333333333333333333333333333333333333333333333333333333333333333333333333333333333333333333333333333333333333333333333333333
333333333333333333333333333333333333333333333333333333333333333333333333333333333333333333333333333333333333333333333333333333333333333333333333333333
